               
               
   17777771    
   17777771    
   17777771    
   17777771    
   17777771    
   17777771    
   17777771    
   11111111    
   11111111    
   11000011    
   11010011    
   11010011    
   11000011    