               
      111      
    1111071    
    1110077    
   111101171   
   111101171   
   111101171   
   111101171   
   117000771   
   177000711   
   171101111   
   171101111   
   171101111   
   171101111   
   17700111    
   11701111    
   111111      